00,00,00,00,00,03,08,08,08,08
00,00,00,11,05,04,10,09,02,08
00,00,11,04,08,08,07,00,03,08
08,08,08,22,15,16,06,13,03,08
08,08,22,23,14,24,16,06,04,08
08,22,23,14,14,14,24,15,16,08
12,20,26,25,19,26,14,25,18,08
00,00,21,24,15,23,25,18,08,08
00,00,20,19,19,19,18,08,08,08
08,08,08,08,08,08,08,08,08,08

0,0,0,0,0,0,0,0,0,0
0,0,0,0,0,0,0,0,0,0
0,0,0,0,0,0,0,0,0,0
0,0,0,0,0,0,0,0,0,0
0,0,0,1,1,1,0,0,0,0
0,0,1,0,1,0,1,0,0,0
0,0,1,0,0,0,0,1,0,0
0,0,0,1,0,1,1,0,0,0
0,0,0,0,0,0,0,0,0,0
0,0,0,0,0,0,0,0,0,0

